*************************************
Maze: 1

XXXXXX
X * .X
X * .X
X @  X
X    X
XXXXXX

*************************************
Maze: 2

XXXXX
X *.X
X @ X
X   X
XXXXX

*************************************
Maze: 3

XXXXXX
X * .X
X @  X
X    X
XXXXXX

*************************************
Maze: 4

XXXXXX
X * .X
X    X
X @  X
X    X
XXXXXX

*************************************
Maze: 5

@
 *
  .

*************************************
